#NR 03
#TITLE Level 03
#ROOMS 03
#FINAL F3 02 10 02
#START 150 350 09
#INTRO
Das ist ein Beispielintro, dass vor dem Level ausgestrahlt werden könnte.
Es kann mehrzeilig sein
#END
#NEWROOM 00
#LEVEL
W1 W1 W1 W1 W1 W1 W1 W1 G1 G1 W1 W1 W1 W1 W1 W1 W1 W1 W1 W1 
W1 G1 G1 G1 G1 G1 G1 G1 G1 G1 G1 G1 G1 G1 W1 G1 G1 G1 W1 W1 
W1 G1 G1 G1 G1 G1 G1 G1 G1 G1 G1 G1 G1 G1 W1 G1 G1 G1 G1 W1 
W1 G1 G1 G1 G1 G1 G1 G1 G1 G1 G1 G1 G1 G1 G1 G1 G1 G1 G1 W1 
W1 G1 G1 G1 G1 G1 G1 G1 G1 G1 G1 G1 G1 G1 G1 G1 G1 G1 G1 W1 
W1 G1 G1 G1 G1 G1 G1 G1 G1 G1 G1 G1 G1 G1 G1 G1 G1 G1 G1 W1 
W1 G1 G1 G1 G1 G1 G1 G1 G1 G1 G1 G1 G1 G1 G1 G1 G1 G1 G1 W1 
W1 G1 G1 G1 G1 G1 G1 G1 G1 G1 G1 G1 G1 G1 G1 G1 G1 G1 G1 W1 
W1 G1 G1 G1 G1 G1 G1 G1 G1 G1 G1 G1 G1 G1 G1 G1 G1 G1 G1 W1 
W1 G1 G1 G1 G1 G1 G1 G1 G1 G1 G1 G1 G1 G1 G1 G1 G1 G1 G1 W1 
W1 G1 G1 G1 G1 G1 G1 G1 G1 G1 G1 G1 G1 G1 G1 G1 G1 G1 G1 W1 
W1 G1 G1 G1 G1 G1 G1 G1 G1 G1 G1 G1 G1 G1 G1 G1 G1 G1 G1 W1 
W1 G1 G1 G1 G1 G1 G1 G1 G1 G1 G1 G1 G1 G1 G1 G1 G1 G1 G1 W1 
W1 W1 W1 W1 W1 W1 W1 W1 W1 W1 W1 W1 W1 W1 W1 W1 W1 W1 W1 W1 

#DOOR 
#EXIT 01 -1 -1 -1
#ENEMY  
#INTERACT S1 630 120 
#ITEM I1 330 500 I1 350 500 I1 370 500 I1 390 500 I1 410 500 I1 430 500 I1 450 500 I1 470 500 I1 490 500 I1 510 500 I1 530 500 I1 330 480 I1 350 480 I1 370 480 I1 390 480 I1 410 480 I1 430 480 I1 450 480 I1 470 480 I1 490 480 I1 510 480 I1 530 480 I2 100 100
#DIALOG

#DIAEND

#NEWROOM 01
#LEVEL
W1 W1 W1 W1 W1 W1 W1 W1 G1 G1 W1 W1 W1 W1 W1 W1 W1 W1 W1 W1 
W1 G1 G1 G1 G1 G1 G1 G1 G1 G1 G1 G1 G1 G1 G1 G1 G1 G1 G1 W1 
W1 G1 G1 G1 G1 G1 G1 W1 G1 G1 W1 G1 G1 G1 G1 G1 G1 G1 G1 W1 
W1 G1 G1 G1 G1 G1 G1 G1 G1 G1 G1 G1 G1 G1 G1 G1 G1 G1 G1 W1 
W1 G1 G1 G1 G1 G1 G1 W1 G1 G1 W1 G1 G1 G1 G1 G1 G1 G1 G1 W1 
W1 G1 G1 G1 G1 G1 G1 G1 G1 G1 G1 G1 G1 G1 G1 G1 G1 G1 G1 W1 
W1 G1 G1 G1 G1 G1 G1 W1 G1 G1 W1 G1 G1 G1 G1 G1 G1 G1 G1 W1 
W1 G1 G1 G1 G1 G1 G1 G1 G1 G1 G1 G1 G1 G1 G1 G1 G1 G1 G1 W1 
W1 G1 G1 G1 G1 G1 G1 G1 G1 G1 G1 G1 G1 G1 G1 G1 G1 G1 G1 W1 
W1 G1 G1 G1 G1 G1 G1 G1 G1 G1 G1 G1 G1 G1 G1 G1 G1 G1 G1 W1 
W1 G1 G1 G1 G1 G1 G1 G1 G1 G1 G1 G1 G1 G1 G1 G1 G1 G1 G1 W1 
W1 G1 G1 G1 G1 G1 G1 G1 G1 G1 G1 G1 G1 G1 G1 G1 G1 G1 G1 W1 
W1 G1 G1 G1 G1 G1 G1 W1 G1 G1 W1 G1 G1 G1 G1 G1 G1 G1 G1 W1 
W1 W1 W1 W1 W1 W1 W1 W1 G1 G1 W1 W1 W1 W1 W1 W1 W1 W1 W1 W1 

#DOOR 
#EXIT 02 -1 00 -1
#ENEMY E1 03 12 E1 15 11 E1 17 07 
#INTERACT C0 120 120 
#ITEM I1 050 050 I1 070 050 I1 090 050 I1 110 050 I1 130 050 I1 150 050 I1 170 050 I1 190 050 I1 210 050 I1 230 050 I1 250 050 I1 050 070 I1 070 070 I1 090 070 I1 110 070 I1 130 070 I1 150 070 I1 170 070 I1 190 070 I1 210 070 I1 230 070 I1 250 070 I1 050 090 I1 070 090 I1 090 090 I1 110 090 I1 130 090 I1 150 090 I1 170 090 I1 190 090 I1 210 090 I1 230 090 I1 250 090 J1 700 050 I3 600 050 
#DIALOG

#DIAEND

#NEWROOM 02
#LEVEL
W1 W1 W1 W1 W1 W1 W1 W1 G1 G1 G1 G1 W1 W1 W1 W1 W1 W1 W1 W1 
W1 G1 G1 G1 G1 G1 G1 W1 G1 G1 G1 G1 W1 G1 G1 G1 G1 G1 G1 W1 
W1 G1 G1 G1 G1 G1 G1 G1 G1 G1 G1 G1 G1 G1 G1 G1 G1 G1 G1 W1 
W1 G1 G1 G1 G1 G1 G1 G1 G1 G1 G1 G1 G1 G1 G1 G1 G1 G1 G1 W1 
W1 G1 G1 G1 G1 G1 G1 G1 G1 G1 G1 G1 G1 G1 G1 G1 G1 G1 G1 W1 
W1 G1 G1 G1 G1 G1 G1 G1 G1 G1 G1 G1 G1 G1 G1 G1 G1 G1 G1 W1 
W1 G1 G1 G1 G1 G1 G1 G1 G1 G1 G1 G1 G1 G1 G1 G1 G1 G1 G1 W1 
W1 G1 G1 G1 G1 G1 G1 G1 G1 G1 G1 G1 G1 G1 G1 G1 G1 G1 G1 W1 
W1 G1 G1 G1 G1 G1 G1 G1 G1 G1 G1 G1 G1 G1 G1 G1 G1 G1 G1 W1 
W1 G1 G1 G1 G1 G1 G1 G1 G1 G1 G1 G1 G1 G1 G1 G1 G1 G1 G1 W1 
W1 G1 G1 G1 G1 G1 G1 G1 G1 G1 G1 G1 G1 G1 G1 G1 G1 G1 G1 W1 
W1 G1 G1 G1 G1 G1 G1 G1 G1 G1 G1 G1 G1 G1 G1 G1 G1 G1 G1 W1 
W1 G1 G1 G1 G1 G1 G1 G1 G1 G1 G1 G1 G1 G1 G1 G1 G1 G1 G1 W1 
W1 W1 W1 W1 W1 W1 W1 W1 G1 G1 G1 W1 W1 W1 W1 W1 W1 W1 W1 W1

#DOOR D1 08 00 c D1 09 00 c D1 10 00 c D1 11 00 c 
#EXIT -2 -1 01 -1
#ENEMY  
#INTERACT
#ITEM
#DIALOG

#DIAEND
